########
#  #   #
# @@ @ #
#  #A# #
#  #@# #
#  oooo#
#  #  ##
########