########
#A #ooo#
#  @@  #
# @   ##
#  ####
#  #
#  #
####