#######
##  o #
#   # #
# o@  #
#  #@##
## A ##
#######